~~~~~~~~~~~~~~~~~~~~~~~~~~~~~~~~~~~~~~~~~~~~~~~~~~~~~~~~~~~~~~~~~~~~~~bI##########################################################################################
~~~~~~~~~~~~~~~~~~~~~~~~~~~~~~~~~~~~~~~~~~~~~~~~~~~~~~~~~~~~~~~~~~~~~~~~I#########################################################################################
~~~~~~~Ib~~~~~~~~~~~~~~~~~~~~~~~~~~~~~~~~~~~~~~~~~~~~~~~~~~~~~~~~~~~~~~~~~################*#############*#############*#############*#############*###############
~~~~~~~~~~~~~~~~~~~~~~~~~~~~~~~~~~~~~~~~~b~~~~~~~~~~~~~~~~~~~~~~~~~~~~~~~I##############*****#########*****#########*****#########*****#########*****#############
~~~~~~~~~~~~~~~~~~~~~~~~~#b~~~~~~~~~~~~~~Ibbb~~~~~~~~~~~~~~~~~~~~~~~~~~~~###############*****#########*****#########*****#########*****#########*****#############
~~~~~~~~~~~~~~~~~~~~~~~~I##~~~~~~~~~~~~~~~~I~~~~~~~~~~~~~~~~~~~~~~~~~~~~~######______--|-___-|--___--|-___-|--___--|-___-|--___--|-___-|--___--|-___-|---____#####
~~~~~~~~~~~~~~~~~~~~~~~~II~~~~~~~~~~~~~~~~~~~~~~~~~~~~~~~~~~~~~~##I~~~~~~######______________________________________________________________________________#####
~~~~~~~~~~~~~~~~~~~~~~~~~~~~~~~~~~~~~~~~~~~~~~~~~~~~~~~~~~~~~b###I~~~~~~~I#####______________________________________________________________________________#####
~~~~~~~~~~~~~~~~~~~~~~~~~~~~~~~~~~~~~~~~~~~~~~~~~~~~~~~~~~~~~~I#I~~~~~~~~I#####______________________________________________________________________________#####
~II~~~~~~~~~~~~~~~~~~~~~~~~~~~~~~~~~~~~~~~~~~~~~~~~~~~~~~~~~~~~~~~~~~~~~~b#####______________________________________________________________________________#####
#######Ib~~~~~~~~~~~~~~~~~~~~~~~~~b~~~~~~~~~~~~~~~~~~~~~~~~~~~~~~~~~~~~I#######______________________________________________________________________________#####
##################=======__==================_===___==========_======##########____________________________________________________________________________#######
##################=======_======================__=_==========__=====##########_________________________________________________________________________```#######
"""""______##_______"""_______"""_______"""_______"""_______"""___________#####_____________________________________________________________________```````#######
"""""______##_____________________________________________________________#####____________________________________________________________________````\\````#####
___________##_____________________________________________________________#####___________________________________________________________________``````\#---#####
````````````````````s````s````````````````````````````````````````````````//`````````````````````````````````````````````````````````````````````````````B``/#####
``K```````````````````````````````````````````````````````````````````````````````````````````````````````````````````````````````````````````````````````t||#####
```````````````````s`````````s````````````````````````````````````````````\\````````````````````````````````````````````````````````````````````````````````\#####
___________##_______s_____________________________________________________#####___________________________________________________________________``````/#---#####
___________##_____________________________________________________________#####____________________________________________________________________````//````#####
___________##_______"""_______"""_______"""_______"""_______"""___________#####_____________________________________________________________________```````#######
###############################################################################_________________________________________________________________________```#######
###############################################################################____________________________________________________________________________#######
..........................................................................#####______________________________________________________________________________#####
..........................................................................#####______________________________________________________________________________#####
..........................................................................#####______________________________________________________________________________#####
..........................................................................#####______________________________________________________________________________#####
..........................................................................#####______________________________________________________________________________#####
..........................................................................#####______--|-___-|--___--|-___-|--___--|-___-|--___--|-___-|--___--|-___-|---____#####
..........................................................................##############*****#########*****#########*****#########*****#########*****#############
..........................................................................##############*****#########*****#########*****#########*****#########*****#############
..........................................................................################*#############*#############*#############*#############*###############
..........................................................................########################################################################################
..........................................................................########################################################################################