~~~~~~~~~~~~~~~~~~~~~~~~~~~~~~~~~~~~~~~~~~~~~~~~~~~~~~~~~~~~~~~~~~~~~~~~~~###################################################################################################################################################################
~~~~~~~~~~~~~~~~~~~~~~~~~~~~~~~~~~~~~~~~~~~~~~~~~~~~~~~~~~~~~~~~~~~~~~~~~~#####..............................................................................#####......................................................................#####
~~~~~~~~~~~~~~~~~~~~~~~~~~~~~~~~~~~~~~~~~~~~~~~~~~~~~~~~~~~~~~~~~~~~~~~~~~#####..............................................................................#####......................................................................#####
~~~~~~~~~~~~~~~~~~~~~~~~~~~~~~~~~~~~~~~~~~~~~~~~~~~~~~~~~~~~~~~~~~~~~~~~~~#####..............................................................................#####......................................................................#####
~~~~~~~~~~~~~~~~~~~~~~~~~~~~~~~~~~~~~~~~~~~~~~~~~~~~~~~~~~~~~~~~~~~~~~~~~~#####..............................................................................#####......................................................................#####
~~~~~~~~~~~~~~~~~~~~~~~~~~~~~~~~~~~~~~~~~~~~~~~~~~~~~~~~~~~~~~~~~~~~~~~~~~#####..............................................................................#####......................................................................#####
~~~~~~~~~~~~~~~~~~~~~~~~~~~~~~~~~~~~~~~~~~~~~~~~~~~~~~~~~~~~~~~~~~~~~~~~~~#####..............................................................................#####......................................................................#####
##################=======..==================.====..==========.======##########..............................................................................#####......................................................................#####
##################=======.======================..=.==========.======##########..............................................................................#####......................................................................#####
...........##.............................................................#####..............................................................................#####......................................................................#####
...........##.............................................................#####..............................................................................#####......................................................................#####
...........##.............................................................#####..............................................................................#####......................................................................#####
.............................................................................................................................................................#####......................................................................#####
.............................................................................................................................................................#####......................................................................#####
.............................................................................................................................................................#####......................................................................#####
...........##.............................................................#####..............................................................................#####......................................................................#####
...........##.............................................................#####..............................................................................#####......................................................................#####
...........##.............................................................#####..............................................................................#####......................................................................#####
###############################################################################..............................................................................#####......................................................................#####
###############################################################################..............................................................................#####......................................................................#####
..........................................................................#####..............................................................................#####......................................................................#####
..........................................................................#####..............................................................................#####......................................................................#####
..........................................................................#####..............................................................................#####......................................................................#####
..........................................................................#####..............................................................................#####......................................................................#####
..........................................................................#####..............................................................................#####......................................................................#####
..........................................................................#####..............................................................................#####......................................................................#####
..........................................................................###################################################################################################################################################################
..........................................................................###################################################################################################################################################################
..........................................................................###################################################################################################################################################################
..........................................................................###################################################################################################################################################################
..........................................................................###################################################################################################################################################################
.............................................................................................................................................................................................................................................
.............................................................................................................................................................................................................................................
.............................................................................................................................................................................................................................................
.............................................................................................................................................................................................................................................
.............................................................................................................................................................................................................................................
.............................................................................................................................................................................................................................................
.............................................................................................................................................................................................................................................
.............................................................................................................................................................................................................................................
.............................................................................................................................................................................................................................................