####################
#>>>>>>>>>>>>>>>>>>#
#___________S_```""#
#"____________```""#
#"_________________#
#":______"""""""""F#
####___#############
#"``````````````````
#"``````````````````
####################