.WWWWWWWWWWWW
.W>}_____v__W
.W__________W
.W__________W
.W>>><}___{>W
WW>>><}___{>W
W_______@___W
W___________W
W\__________W
WF><>>\_____W
WWWWWWWWW}_WW
........W___W
........W___W
........W___W
........WDWWW
