.WWWWWWWWWWWW
.WT}ww___F/wW
.Wv____w__wwW
.Wv_________W
.W+>><}_ww{>W
WW+>><}w_w{>W
W{/_____@__wW
Ww__________W
W\___w___w__W
WF><>>\_____W
WWWWWWWWW}_WW
........W__wW
........Ww__W
........Ww__W
........WDWWW
