~~~~~~~~~~~~~~~~~~~~~~~~~~~~~~~~~~~~~~~~~~~~~~~~~~~~~~~~~~~~~~~~
~~~~~~~~~~~~~~~~~~~~~~~~~~~~~~~~~~~~~~~~~~~~~~~~~~~~~~~~~~~~~~~~
~~~~~~~~~~~~~~~~~~~~~~~~~~~~~~~~~~~~~~~~~~~~~~~~~~~~~~~~~~~~~~~~
~~~~~~~~~~~~~~~~~~~~~~~~~~~~~~~~~~~~~~~~~~~~~~~~~~~~~~~~~~~~~~~~
~~~~~~~~~~~~~~~~~~~~~~~~~~~~~~~~~~~~~~~~~~~~~~~~~~~~~~~~~~~~~~~~
~~~~~~~~~~~~~~~~~~~~~~~~~~~W~~~~~~~~~~~~~~~~~~~~~~~~~~~~~~~~~~~~
~~~~~~~~~~~~~~~~~~~~~~~~~~W-W~~~~~~~~~~~~~~~~~~~~~~~~~~~~~~~~~~~
~~~~~~~~~~~~~~~~~~~~~~~~~W---W~~~~~~~~~~~~~~~~~~~~~~~~~~~~~~~~~~
~~~~~~~~~~~~~~~~~~~~~~~~W-----W~~~~~~~~~~~~~~~~~~~~~~~~~~~~~~~~~
~~~~~~~~~~~~~~~~~~~~~~~W-------W~~~~~~~~~~~~~~~~~~~~~~~~~~~~~~~~
~~~~~~~~~~~~~~~~~~~~~~W---------W~~~~~~~~~~~~~~~~~~~~~~~~~~~~~~~
~~~~~~~~~~~~~~~~~~~~~W-----------W~~~~~~~~~~~~~~~~~~~~~~~~~~~~~~
~~~~~~~~~~~~~~~~~~~~W-------------W~~~~~~~~~~~~~~~~~~~~~~~~~~~~~
~~~~~~~~~~~~~~~~~~~W---------------W~~~~~~~~~~~~~~~~~~~~~~~~~~~~
~~~~~~~~~~~~~~~~~~W----------------pW~~~~~~~~~~~~~~~~~~~~~~~~~~~
~~~~~~~~~~~~~~~~~W-----------------p-W~~~~~~~~~~~~~~~~~~~~~~~~~~
~~~~~~~~~~~~~~~~W------------------p--W~~~~~~~~~~~~~~~~~~~~~~~~~
~~~~~~~~~~~~~~~Wpp-----------------p---W~~~~~~~~~~~~~~~~~~~~~~~~
~~~~~~~~~~~~~~~W-pppp---------pppppp---W~~~~~~~~~~~~~~~~~~~~~~~~
~~~~~~~~~~~~~~W-----F}--{>>pTp/---------W~~~~~~~~~~~~~~~~~~~~~~~
~~~~~~~~~~~~~~W----p>}--{>>+S+>pppppT>>>W~~~~~~~~~~~~~~~~~~~~~~~
~~~~~~~~~~~~~Wpppppp-------p-p------F>>>>W~~~~~~~~~~~~~~~~~~~~~~
~~~~~~~~~~~~~W------------pp-pp----------W~~~~~~~~~~~~~~~~~~~~~~
~~~~~~~~~~~~W------------pp---p}----------W~~~~~~~~~~~~~~~~~~~~~
~~~~~~~~~~~~W-.......__-{p-------........-W~~~~~~~~~~~~~~~~~~~~~
~~~~~~~~~~~W--.......__----------........--W~~~~~~~~~~~~~~~~~~~~
~~~~~~~~~~~W--.......__-------p}-........--W~~~~~~~~~~~~~~~~~~~~
~~~~~~~~~~W---.......__-{p----p--........---W~~~~~~~~~~~~~~~~~~~
~~~~~~~~~~W--------------p----p-------------W~~~~~~~~~~~~~~~~~~~
~~~~~~~~~WWWWWWWWWWWWWWWWW...WWWWWWWWWWWWWWWWW~~~~~~~~~~~~~~~~~~
~~~~~~~~~W...............W...W...............W~~~~~~~~~~~~~~~~~~
~~~~~~~~WW...............W...W...............WW~~~~~~~~~~~~~~~~~
~~~~~~~~W................W...W...............WW~~~~~~~~~~~~~~~~~
~~~~~~~~W................W...W...............WW~~~~~~~~~~~~~~~~~
~~~~~~~~W................W...W...............WW~~~~~~~~~~~~~~~~~
~~~~~~~~W...VVVVVVVVDVVVVVDDDVVVVVVVVWWWWWWWWWW~~~~~~~~~~~~~~~~~
~~~~~~~~W...Vv............................WWWWW~~~~~~~~~~~~~~~~~
~~~~~~~~WWWWVv............................WWWWW~~~~~~~~~~~~~~~~~
~~~~~~~~W...V^............................W...W~~~~~~~~~~~~~~~~~
~~~~~~~~W...V^..VVVVVVVDVVVVVV...V====W...W...W~~~~~~~~~~~~~~~~~
~~~~~~~~WWWWVv..V............V...V....W...WWWWW~~~~~~~~~~~~~~~~~
~~~~~~~~W...Vv..V............V...V....W...W...W~~~~~~~~~~~~~~~~~
~~~~~~~~W...V^..V............V...V....W...W...W~~~~~~~~~~~~~~~~~
~~~~~~~~WWWWVv..V............V...V....W...WWWWW~~~~~~~~~~~~~~~~~
~~~~~~~~W...Vv..V............V...V....W...W...W~~~~~~~~~~~~~~~~~
~~~~~~~~W...Vv..VWWWWWWVVVVVVV---V....W...W...W~~~~~~~~~~~~~~~~~
~~~~~~~VVVVVV/..VT}N+<fV---------VWWWWW...WWWWWW~~~~~~~~~~~~~~~~
~~~~~~~VtttV....Vv.3n.4V---------V....W....W...W~~~~~~~~~~~~~~~~
~~~~~~~Vb..D....Vv.....V---------V....W....W...W~~~~~~~~~~~~~~~~
~~~~~~~VWWWV..B}V+>}.{>V---------V....W....WWWWW~~~~~~~~~~~~~~~~
~~~~~~~VBf-V..FVV+>}.{>V---------V....WW...W...W~~~~~~~~~~~~~~~~
~~~~~~BV+f.D...V{/.....V---------V.....W...W...W~~~~~~~~~~~~~~~~
~~~~~~pVpf.WDDDW\..2...V---------V.....W...WWWWW~~~~~~~~~~~~~~~~
~~~~~~pVp--W...WF><o\1.V---------V.....W...W...W~~~~~~~~~~~~~~~~
~~~~~~pVpppw...WWWEWWL.V---------VVWWWWW...W...W~~~~~~~~~~~~~~~~
~~~~~~pVp-pW...Fn......V----------V........WWWWW~~~~~~~~~~~~~~~~
~~~~~~pVp-pW........WWWVV---------V........W...W~~~~~~~~~~~~~~~~
~~~~~~pVp-pWT\.....BW...V---------V........W...W~~~~~~~~~~~~~~~~
~~~~~~pWWWWWWWDWW..vW...V---------V...WWWWWWWWWW~~~~~~~~~~~~~~~~
~~~~~~FW--------W..vWWWWV---------V...W--------W~~~~~~~~~~~~~~~~
~~~~~~~W--------W..vW...V---------V...W--------W~~~~~~~~~~~~~~~~
~~~~~~~W--------W..vW...V---------V...W--------W~~~~~~~~~~~~~~~~
~~~~~~~W--------W..vWWWWV---------V...W--------W~~~~~~~~~~~~~~~~
~~~~~~~W--------W..vW...V----VVVVVV...W--------W~~~~~~~~~~~~~~~~
~~~~~~~W--------W..vW...V----V....W...W--------W~~~~~~~~~~~~~~~~
~~~~~~~W--------W..vWWWWV----V....W...W--------W~~~~~~~~~~~~~~~~
~~~~~~~W--------W..FW...V----V....W...W--------W~~~~~~~~~~~~~~~~
~~~~~~~W--------W...W...V----V....W...W--------W~~~~~~~~~~~~~~~~
~~~~~~~WWWWWWWDWW...WWWWVVVVVVWWWWW...WWWWWWWWWW~~~~~~~~~~~~~~~~
~~~~~~~Wb..D........W.....W.......W........W...W~~~~~~~~~~~~~~~~
~~~~~~~Wb.tW........W.....W.......W........W...W~~~~~~~~~~~~~~~~
~~~~~~~WWWWW..B<>>>>W.....W.......W........W...W~~~~~~~~~~~~~~~~
~~~~~~~Wb..D..vWWMWWW.....W.......WWWWWW...W...W~~~~~~~~~~~~~~~~
~~~~~~~Wb.tW..FWks.bW.....W............W...W...W~~~~~~~~~~~~~~~~
~~~~~~~WWWWW...D.@.bW.....W............W...WWWWW~~~~~~~~~~~~~~~~
~~~~~~~Wb..D...W\...W.....W............W...W...W~~~~~~~~~~~~~~~~
~~~~~~~Wb.tW..BW/..0W.....W............W...W...W~~~~~~~~~~~~~~~~
~~~~~~~WWEWW..vWH.ttW.....W............W...WWWWW~~~~~~~~~~~~~~~~
~~~~~~~Wb..D..vWWWWWWWWWWWWWWWWWWWWWWWWW...W...W~~~~~~~~~~~~~~~~
~~~~~~~Wu.tW..vW.......................W...W...W~~~~~~~~~~~~~~~~
~~~~~~~WWWWW..^W.......................W...WWWWW~~~~~~~~~~~~~~~~
~~~~~~~Wb..D..vW..............WWWWWWWWWW...W...W~~~~~~~~~~~~~~~~
~~~~~~~Wb.tW..vWWWWWWWWWWWWWWWW........W...W...W~~~~~~~~~~~~~~~~
~~~~~~~WWWWW..^W....W....W....W........W...WWWWW~~~~~~~~~~~~~~~~
~~~~~~~Wb..D..vW....W....W....W........W...W...W~~~~~~~~~~~~~~~~
~~~~~~~Wb.tW..vW....W....W....W........W...W...W~~~~~~~~~~~~~~~~
~~~~~~~WWWWW..FW....W....W....W........W...WWWWW~~~~~~~~~~~~~~~~
~~~~~~~Wb..D...W....W....W....W........W...W...W~~~~~~~~~~~~~~~~
~~~~~~~Wt..W...W....W....W....W........W...W...W~~~~~~~~~~~~~~~~
~~~~~~~WWEWW...WWWDWWWEDWWWWDWWWWWWWWWWWDDDWWWWW~~~~~~~~~~~~~~~~
~~~~~~~Wb..D............F>/................W...W~~~~~~~~~~~~~~~~
~~~~~~~Wb.bW...............................W...W~~~~~~~~~~~~~~~~
~~~~~~~Wt.bW>>>T<>><>\......B>><T}.........W...W~~~~~~~~~~~~~~~~
~~~~~~~WWWWWWWWWWWwWWWwWWW..vWWWWWWWWWWWWWWWWWWW~~~~~~~~~~~~~~~~
~~~~~~~~WWWWWWWW.hth.hth.W..vWAAth.hQAWWWWWWWWW~~~~~~~~~~~~~~~~~
~~~~~~~~~WWWWWWW.hth.....W..FWtth.....WWWWWWWW~~~~~~~~~~~~~~~~~~
~~~~~~~~~~WWWWWW.hth.hth.D...D.......|WWWWWWW~~~~~~~~~~~~~~~~~~~
~~~~~~~~~~~WWWWW.hth.hth.W...Wu......dWWWWWW~~~~~~~~~~~~~~~~~~~~
~~~~~~~~~~~~WWWW.........W...Wh......mWWWWW~~~~~~~~~~~~~~~~~~~~~
~~~~~~~~~~~~~WWWWWWWWWWDWW...Wru.....AWWWW~~~~~~~~~~~~~~~~~~~~~~
~~~~~~~~~~~~~~WWWrUOS--..D...Wr....$hhWWW~~~~~~~~~~~~~~~~~~~~~~~
~~~~~~~~~~~~~~~WWr-----u.W...WH..httttWW~~~~~~~~~~~~~~~~~~~~~~~~
~~~~~~~~~~~~~~~~WWWWWWVVVVVDVVVVVWWWWWW~~~~~~~~~~~~~~~~~~~~~~~~~
~~~~~~~~~~~~~~~~~~~~~~V-'l---l'-V~~~~~~~~~~~~~~~~~~~~~~~~~~~~~~~
~~~~~~~~~~~~~~~~~~~~~~V---'--''-V~~~~~~~~~~~~~~~~~~~~~~~~~~~~~~~
~~~~~~~~~~~~~~~~~~~~~~~V'l'l'l-V~~~~~~~~~~~~~~~~~~~~~~~~~~~~~~~~
~~~~~~~~~~~~~~~~~~~~~~~~VVVVVVV~~~~~~~~~~~~~~~~~~~~~~~~~~~~~~~~~
~~~~~~~~~~~~~~~~~~~~~~~~~~~~~~~~~~~~~~~~~~~~~~~~~~~~~~~~~~~~~~~~
~~~~~~~~~~~~~~~~~~~~~~~~~~~~~~~~~~~~~~~~~~~~~~~~~~~~~~~~~~~~~~~~
~~~~~~~~~~~~~~~~~~~~~~~~~~~~~~~~~~~~~~~~~~~~~~~~~~~~~~~~~~~~~~~~
~~~~~~~~~~~~~~~~~~~~~~~~~~~~~~~~~~~~~~~~~~~~~~~~~~~~~~~~~~~~~~~~
~~~~~~~~~~~~~~~~~~~~~~~~~~~~~~~~~~~~~~~~~~~~~~~~~~~~~~~~~~~~~~~~
~~~~~~~~~~~~~~~~~~~~~~~~~~~~~~~~~~~~~~~~~~~~~~~~~~~~~~~~~~~~~~~~
~~~~~~~~~~~~~~~~~~~~~~~~~~~~~~~~~~~~~~~~~~~~~~~~~~~~~~~~~~~~~~~~
~~~~~~~~~~~~~~~~~~~~~~~~~~~~~~~~~~~~~~~~~~~~~~~~~~~~~~~~~~~~~~~~
~~~~~~~~~~~~~~~~~~~~~~~~~~~~~~~~~~~~~~~~~~~~~~~~~~~~~~~~~~~~~~~~
~~~~~~~~~~~~~~~~~~~~~~~~~~~~~~~~~~~~~~~~~~~~~~~~~~~~~~~~~~~~~~~~
~~~~~~~~~~~~~~~~~~~~~~~~~~~~~~~~~~~~~~~~~~~~~~~~~~~~~~~~~~~~~~~~
~~~~~~~~~~~~~~~~~~~~~~~~~~~~~~~~~~~~~~~~~~~~~~~~~~~~~~~~~~~~~~~~
~~~~~~~~~~~~~~~~~~~~~~~~~~~~~~~~~~~~~~~~~~~~~~~~~~~~~~~~~~~~~~~~
~~~~~~~~~~~~~~~~~~~~~~~~~~~~~~~~~~~~~~~~~~~~~~~~~~~~~~~~~~~~~~~~
~~~~~~~~~~~~~~~~~~~~~~~~~~~~~~~~~~~~~~~~~~~~~~~~~~~~~~~~~~~~~~~~
~~~~~~~~~~~~~~~~~~~~~~~~~~~~~~~~~~~~~~~~~~~~~~~~~~~~~~~~~~~~~~~~
~~~~~~~~~~~~~~~~~~~~~~~~~~~~~~~~~~~~~~~~~~~~~~~~~~~~~~~~~~~~~~~~
~~~~~~~~~~~~~~~~~~~~~~~~~~~~~~~~~~~~~~~~~~~~~~~~~~~~~~~~~~~~~~~~
~~~~~~~~~~~~~~~~~~~~~~~~~~~~~~~~~~~~~~~~~~~~~~~~~~~~~~~~~~~~~~~~
~~~~~~~~~~~~~~~~~~~~~~~~~~~~~~~~~~~~~~~~~~~~~~~~~~~~~~~~~~~~~~~~
~~~~~~~~~~~~~~~~~~~~~~~~~~~~~~~~~~~~~~~~~~~~~~~~~~~~~~~~~~~~~~~~