................................................................
................................................................
................................................................
................................................................
................................................................
...........................W....................................
..........................W_W...................................
.........................W___W..................................
........................W_____W.................................
.......................W_______W................................
......................W_________W...............................
.....................W___________W..............................
....................W_____________W.............................
...................W_______________W............................
..................W_________________W...........................
.................W___________________W..........................
................W_____________________W.........................
...............W_______________________W........................
...............W_______________________W........................
..............W_________________________W.......................
..............W_________________________W.......................
.............W___________________________W......................
.............W___________________________W......................
............W_____________________________W.....................
............W_____________________________W.....................
...........W_______________________________W....................
...........W_______________________________W....................
..........W_________________________________W...................
..........W_________________________________W...................
.........WWWWWWWWWWWWWWWWW___WWWWWWWWWWWWWWWWW..................
.........W_______________W___W_______________W..................
........WW_______________W___W_______________WW.................
........W________________W___W_______________WW.................
........W________________W___W_______________WW.................
........W________________W___W_______________WW.................
........W___WWWWWWWWDWWWWWDDDWWWWWWWWWWWWWWWWWW.................
........W___W_____________________________WWWWW.................
........WWWWW_____________________________WWWWW.................
........W___W_____________________________W___W.................
........W___W___WWWWWWWDWWWWWW___W====W___W___W.................
........WWWWW___W____________W___W____W___WWWWW.................
........W___W___W____________W___W____W___W___W.................
........W___W___W____________W___W____W___W___W.................
........WWWWW___W____________W___W____W___WWWWW.................
........W___W___W____________W___W____W___W___W.................
........W___W___WVVWWVWWWWWWWW---W____W___W___W.................
.......WWWWWW___WT}P+<fW---------WWWWWW___WWWWWW................
.......WtttW____Wv_3p,4V---------W____W____W___W................
.......Wb__D____Vv_____W---------W____W____W___W................
.......WWWWW____W+>},{>W---------W____W____WWWWW................
.......Wtt_W___WW+>},{>V---------W____WW___W___W................
.......Wb__D___V{/____,V---------W_____W___W___W................
.......WWWWW___W\__2,_,W---------W_____W___WWWWW................
.......W___W___WF><o\1_W---------W_____W___W___W................
.......W___D___WWVWVWL_V---------WWWWWWW___W___W................
.......W___W________D@,W----------W________WWWWW................
.......W___W________VWWWW---------W________W___W................
.......W___W________W___W---------W________W___W................
.......WWWWWWWDWW___W___W---------W___WWWWWWWWWW...............
.......W--------W___WWWWW---------W___W--------W................
.......W--------W___W___W---------W___W--------W................
.......W--------W___W___W---------W___W--------W................
.......W--------W___WWWWW---------W___W--------W................
.......W--------W___W___W----WWWWWW___W--------W................
.......W--------W___W___W----W____W___W--------W................
.......W--------W___WWWWW----W____W___W--------W................
.......W--------W___W___W----W____W___W--------W................
.......W--------W___W___W----W____W___W--------W...............
.......WWWWWWWDWW___WWWWWWWWWWWWWWW___WWWWWWWWWW................
.......W___W________W_____W_______W________W___W................
.......W___W________W_____W_______W________W___W................
.......WWWWW________W_____W_______W________W___W................
.......W___W___WWWWWW_____W_______WWWWWW___W___W................
.......W___W___W____W_____W____________W___W___W................
.......WWWWW___D____W_____W____________W___WWWWW................
.......W___W___W____W_____W____________W___W___W................
.......W___W___W____W_____W____________W___W___W................
.......WWWWW___W____W_____W____________W___WWWWW................
.......W___W___WWWWWWWWWWWWWWWWWWWWWWWWW___W___W................
.......W___W___W_______________________W___W___W................
.......WWWWW___W_______________________W___WWWWW................
.......W___W___W______________WWWWWWWWWW___W___W................
.......W___W___WWWWWWWWWWWWWWWW________W___W___W................
.......WWWWW___W____W____W____W________W___WWWWW................
.......W___W___W____W____W____W________W___W___W................
.......W___W___W____W____W____W________W___W___W................
.......WWWWW___W____W____W____W________W___WWWWW................
.......W___W___W____W____W____W________W___W___W................
.......W___W___W____W____W____W________W___W___W................
.......WWWWW___WWWDWWWWDWWWWDWWWWWWWWWWW___WWWWW................
.......W___W_______________________________W___W................
.......W___W_______________________________W___W................
.......W___W_______________________________W___W................
.......WWWWWWWWWWWWWWWWWWW___WWWWWWWWWWWWWWWWWWW................
........WWWWWWWWW________W___W________WWWWWWWWW.................
.........WWWWWWWW________W___W________WWWWWWWW..................
..........WWWWWWW________D___D________WWWWWWW...................
...........WWWWWW________W___W________WWWWWW....................
............WWWWW________W___W________WWWWW.....................
.............WWWWWWWWWWDWW___W________WWWW......................
..............WWW________D___W________WWW.......................
...............WW________W___W________WW........................
................WWWWWWWWWWWDWWWWWWWWWWW.........................
......................W---------W...............................
......................W---------W...............................
.......................W-------W................................
........................WWWWWWW.................................
................................................................
................................................................
................................................................
................................................................
................................................................
................................................................
................................................................
................................................................
................................................................
................................................................
................................................................
................................................................
................................................................
................................................................
................................................................
................................................................
................................................................
................................................................
................................................................
................................................................
................................................................