.WWWWWWWWWWWW
.W>}________W
.W__________W
.W__________W
.W__________W
WW__________W
W_______@___W
W___________W
W___________W
WB>>>B>\____W
WWWWWWWWW}_WW
........W___W
........W___W
........W___W
........WDWWW