.WWWWWWWW
.WT}P+<fW
.Wv_3pw4W
.Wv_____W
.W+>}w{>W
WW+>}w{>W
W{/____wW
W\__2w_wW
WF><o\1_W
WWWWWWL_W
.....Ww@W
.....WDWW