.WWWWWWWWWWWW
.WT}ww___F/wW
.Wv____w__w4W
.Wv_3_______W
.W+>><}_ww{>W
WW+>><}w_w{>W
W{/________wW
Ww__________W
W\__2w___w__W
WF><>>\__1__W
WWWWWWWWW}_WW
........W__wW
........Ww__W
........Ww@_W
........WDWWW
