.WWWWWWWWWWWW
.W>}ww___F/wW
.Ww____w__wwW
.W__________W
.W>>><}_ww{>W
WW>>><}w_w{>W
Www_____@__wW
Ww__________W
W\___w___w__W
WF><>>\_____W
WWWWWWWWW}_WW
........W__wW
........Ww__W
........Ww__W
........WDWWW
