.WWWWWWWWWWWW
.WT}ww___F/wW
.Wv_3__w__w4W
.Wv_________W
.W+>><}_ww{>W
WW+>><}w_w{>W
W{/________wW
Ww__________W
W\__2w___w__W
WF><o>\__1__W
WWWWWWWWW}_WW
........W__wW
........Ww__W
........Ww@_W
........WDWWW
