.WWWWWWWWWWWW
.W__________W
.W__________W
.W__________W
.W__________W
WW__________W
W_______@___W
W___________W
W___________W
W___________W
WWWWWWWWW__WW
........W___W
........W___W
........W___W
........WWWWW