SS###SS.@,.,
S_____S,..,,
#_____##.#SS
#_____#....S
#_____..b..#
S_____#....S
SS#%####%#SS
