SS###SS.@,.,..,
S_____S,..,,,.,
#_b___##.#SS,,.
#_____#....S.,,
#_____..bc.#,,,
S_____#....S,,,
SS#%####%#SS,,,
,,,,,,,,.,,,,.,
..,,,,,,,,.,.,,
,,,,,,,,,,,,,,,
