SS###SS.....
S.....S.....
#.....##.#SS
#..@..#....S
#.......b..#
S.....#....S
SS########SS
