......................
......................
......................
......................
.....__________.......
.....__________.......
.....___M______.......
.....__________.......
.....___g@__r__.......
.....__________.......
.....__________.......
.....__________.......
.....__________.......
......................
......................
