~~~~~~~~~~~~~~~~~~~~~~
~~~~~~~~~~~~~~~~~~~~~~
~~~~~~~~~~~~~~~~~~~~~~
~~~~~~~~~~~~~~~~~~~~~~
~~~~~__________~~~~~~~
~~~~~__________~~~~~~~
~~~~~___Q______~~~~~~~
~~~~~__________~~~~~~~
~~~~~___g@__d__~~~~~~~
~~~~~_______r__~~~~~~~
~~~~~__________~~~~~~~
~~~~~__________~~~~~~~
~~~~~__________~~~~~~~
~~~~~~~~~~~~~~~~~~~~~~
~~~~~~~~~~~~~~~~~~~~~~
