~~~~~~~~~~~~~~~~~~~~~~
~~~~~~~~~~~~~~~~~~~~~~
~~~~~~~~~~~~~~~~~~~~~~
~~~~~~~~~~~~~~~~~~~~~~
~~~~~----------~~~~~~~
~~~~~----------~~~~~~~
~~~~~---Q------~~~~~~~
~~~~~----------~~~~~~~
~~~~~--|@------~~~~~~~
~~~~~--dm------~~~~~~~
~~~~~----------~~~~~~~
~~~~~----------~~~~~~~
~~~~~----------~~~~~~~
~~~~~~~~~~~~~~~~~~~~~~
~~~~~~~~~~~~~~~~~~~~~~
