......................
......................
......................
......................
.....__________.......
.....__________.......
.....___M______.......
.....__________.......
.....____@__r__.......
.....__________.......
.....__________.......
.....__________.......
.....__________.......
......................
......................
